# Namenverzeichnis

Alzey: Alzeye
Arabien: arabischem Arabin arabischen
Arras: Arraz
Azagouc: Azagovch

Bayern: Bayerlant Bayerlande Bayerlanden
Bechelaren: Bechlarn Bechelaren
Bern: Berne Bernære
Burgund: Burgunden Burgundn-

Dänemark: Tenemarche Tenemarchen
Dänen: Tenen
Donau: Tvonowe Tunawe Tverne?

Eferding: Everdingen
Elbe: Elbe
Enns: Ense
Etzelburg:

Gran: Gran
Griechenland: Criechen


Hainburg: Heimburch
Hessen: Hessen
Hunnen: Hunin Hunen


Indien: India
Inn: Irn?
Isenstein: Isenstein Isensteine
Island: Islande

Kiew:

Libyen: Libyan Libia
Lochheim: Lorse?

Main: Mein
Marroko: Marroch
Mautern:
Mehring: Moringe
Meisenburg:
Melk: Medeliche
Metz: Metzzen Mezzen Mezzin Metzen

Niederland: Niderlanden
Ninnive: Ninnive
Norwegen: Norwoege

Österreich: Osterland Osterlande Osterriche Osterlant
Ostfranken: Ostervranken Osterfrankchn- Osterffranchen

Passau: Pazzowe
Petschenegen: Petschenaere Pescenære
Pförring: Vergen
Polen: Polanen

Rhein: Rin Rine
Rhone: Roten
Russen: Riuzen?

Sachsen: Sahsen
Schwaben: Swaben
Schwalbfeld: ?
Spanien: Spane
Spessart: Spehtsharte

Thüringen: Durigen
Traisen: Treysem Treysenmvore
Traun: Trvone
Tronje: Tronege Tronge Trong Trongen
Tronjer: Tronegære
Tulln: Tvlme

Ungarland: Vngerlande
Ungarn:

Wärbel: Werbel
Walachen: Vlachen
Waskenstein:
Waskenwald:
Wien: Wiene
Wittich: Witege
Worms: Wormze Wormez Wormeze Wormz

Xanten: Santen

Zazamanc: Zazamanc
Zeiselmauer: ?
